BBBBBBBBBBBBBBBBBBBBBBBBBBBBBBBB
BOOOOOOOOOOOOBBBBBOOOOOOOOOOOOOB
BOOOOOOOOOOOOBBBBBOOOOOOOOOOOOOB
BOOOOOOOOOOOOBBBBBOOOOOOOOOOOOOB
BOOOOOOOOOOOOBBBBBOOOOOOOOOOOOOB
BOOOOOOOOOOOOPOOOOOOOOOOOOOOOOOB
BOOOOOOOOOOOOOOOOOOOOOOOOOOOOOOB
BOOOOOOOOOOOOOOOOOOOOOOOOOOOOOOB
BOOOOOOOOOOOOBBBBBOOOOOOOOOOOOOB
BOOOOOOOOOOOOBBBBBOOOOOOOOOOOOOB
BOOOOOOOOOOOOBBBBBOOOOOOOOOOOOOB
BOOOOOOOOOOOOBBBBBOOOOOOOOOOOOOB
BOOOOOOOOOOOOBBBBBOOOOOOOOOOOOOB
BOOOOOOOOOOOOBBBBBOOOOOOOOOOOOOB
BOOOOOOOOOOOOBBBBBOOOOOOOOOOOOOB
BOOSOOOOOOOOPBBBBBOOOOOOOOOOEOOB
BOOOOOOOOOOOOBBBBBOOOOOOOOOOOOOB
BBBBBBBBBBBBBBBBBBBBBBBBBBBBBBBB
