BBBBBBBBBBBBBBBBBBBBBBBBBBBBBBBB
BEOOOOOOOOOOOOOOOOOOPBMMMMMMMMMB
BOOOOOOOOOOPOOOOOOSOPBMMMMMMMMMB
BBBBBBBBBBBPBBOOOOOOPBMMMMMMMMMB
BMMMMMMMMMBPOOOOOOOOPBMMMMMMMMMB
BMMMMMMMMMBPOOOOOOOOPBMMMMMMMMMB
BMMMMMMMMMBPOOOOOOOOPBMMMMMMMMMB
BMMMMMMMMMBPOOOOOOOOPBMMMMMMMMMB
BMMMMMMMMMBPOOOOOOOOPBMMMMMMMMMB
BMMMMMMMMMBPOOOOOOOOPBMMMMMMMMMB
BMMMMMMMMMBPOOOOOOOOPBMMMMMMMMMB
BMMMMMMMMMBPOOOOOOOOOBMMMMMMMMMB
BMMMMMMMMMBPOOOOOOOOOBMMMMMMMMMB
BMMMMMMMMMBPOOOOOOOOOBMMMMMMMMMB
BMMMMMMMMMBPOOOOOBBBOBMMMMMMMMMB
BMMMMMMMMMBPOOOOOOOOOBMMMMMMMMMB
BMMMMMMMMMBMMMMMMMMMMBMMMMMMMMMB
BBBBBBBBBBBBBBBBBBBBBBBBBBBBBBBB