BBBBBBBBBBBBBBBBBBBBBBBBBBBBBBBB
BPOOOOOOOOOOOOOOOOOOOOOOOOOOOOEB
BOOOOOOOOOOOOOOOOOOOOOOOOOOOOOOB
BOOOOOOOOOOOOOOOOOOOOOOOOOOOBBBB
BOOOOOOOOOOOOOOOOOOOOOOOOOOBOOOB
BOOOOOOOOOOOOOOOOOOOOOOOOOOOOOOB
BOOOOOOOOOOOOOOOOOOOOOOOOOOOOOOB
BOOOOOOOOOOOOOOOOOOOOOBBBBOOOOOB
BOOOOOOOOOOOOOOOOOOOOOOOOOOOOOOB
BOOOOOOOOOOOOOOOOOOOOOOOOOOOOOOB
BOOOOOOOOOOOOOOOOOOOOOOOOOOOOOOB
BOOOOOOOOOOOOOOOOOOOOOOOOOOOOOOB
BOOOOOOOOOOOOOOOOOOOOOOOOOOOOPOB
BOOOOOOOOOOOOOOOOOOOOOOOOOOOOOOB
BOOOOOPOOOOOOOOOOOOOOOOOOOOOOOOB
BSOOOOOOOOOOOOOOOOOOOOOOOOOOOOOB
BOOOOOCOOOOOOOOOOOOOOOOOOOOOOOOB
BBBBBBBBBBBBBBBBBBBBBBBBBBBBBBBB