BBBBBBBBBBBBBBBBBBBBBBBBBBBBBBBB
BOOOOOOOOOOOOOOOOOOOOOOOOOPOOOEB
BOOOOOOOOOOOOOOOOOOOOOOOOOOOOOOB
BOOOOOOOOOOOOOOOOOOOOOOOOBBBBBBB
BOOOOOOOOOOOOOOOOOOOOOOOOOOOOOOB
BOOOOOOOOOOOOOOOOOOOOOOOOOOOOOOB
BOOOOOOOOOOOOOOOOOOOOOOOOOOOOOOB
BPOOOOOOOOOOCOOOOOOOOOOOOOOOOOOB
BOOOOOOOOOOOBOOOOOOOOOOOOOOOOOOB
BOOOOOOOOOCOBOOOOOOOOOOOOOOOOOOB
BOOOOOOOOOBOBOOOOOOOOOOOOOOOOOOB
BOOOOOOOOOBOBOOOOOOOOOOOOOOOOOOB
BOOOOOOOCOBOBOOOOOOOOOOOOOOOOOOB
BOOOOOOOBOBOBOOOOOOOOOOOOOOOOOOB
BOOOOOOOBOBOBOOOOOOOOOOOOOOOOOOB
BSOOOOCOBOBOBOOOOOOOOOOOOOOOOOOB
BOOOOOBOBOBOBOOOOOOOOOOOOOOOOOOB
BBBBBBBBBBBBBBBBBBBBBBBBBBBBBBBB