BBBBBBBBBBBBBBBBBBBBBBBBBBBBBBBB
BOOOOOOOOOOOOOOOOOOOOOOOOOOOOOOB
BOOOOOOOOOOOOOOOOOOOOOOOOOOOOOOB
BOOOOOOOOOOOOOOOOOOOOOOOOOOOOOOB
BOOOOOOOOOOOOOOOOOOOOOOOOOOOOOOB
BOOOOOOOOOOOOOOOOOOOOOOOOOOOOOOB
BOOOOOOOOOOOOOOOOOOOOOOOOOOOOOOB
BOOOOOOOOOOOOOOOOOOOOOOOOOOOOOOB
BOOOOOOOOOOOOOOOOOOOOOOOOOOOOOOB
BOOOOOOOOOOOOOOOOOOOOOOOOOOOOOOB
BOOOOOOOOOOOOOOOOOOOOOOOOOOOOOOB
BOOOOOOOOOOOOOOOOOOOOOOOOOOOOOOB
BOOOOOOOOOOOOOOOOOOOOOOOOOOOOOOB
BOOOOOOOOOOOOOOOOOOOOOOOOOOOOOOB
BOOOOOOOOOOOOOOOOOOOOOOOOOOOOOOB
BOOOOOOOOOOOOOOOOOOOOOOOOOOOOOOB
BSOOOOOOOOOOOOOOOOOOOOOOOOOOOOEB
BBBBBBBBBBBBBBBBBBBBBBBBBBBBBBBB