BBBBBBBBBBBBBBBBBBBBBBBBBBBBBBBB
BOOOOOOOOOOOOOOOOOOOOOOOOOOOOOOB
BOOOOOOOOOOOOOOOOOOOOOOOOOOOOOOB
BOOOOOOOOOOOOOOOOOOOOOOOOOOOOOOB
BOOOOOOOOOOOOOOOOOOOOOOOOOOOOOOB
BOOOOOOOOOOOOOOOOOOOOOOOOOOOOOOB
BOOOOOOOOOOOOOOOOOOOOOOOOOOOOOOB
BOOOOOOOOOOOOOOOOOOOOOOOOOOOOOOB
BOOOOOOOOOOOOOOOOOOOOOOOOOOOOOOB
BOOOOOOOOOOOOOOOOOOOOOOOOOOOOOOB
BOOOOOOOOOOOOOOOOOOOOOOOOOOOOOOB
BOOOOOOOOOOOOOOOOOOOOOOOOOOOOOOB
BSOOOOOOOOOOOOOOOOOOOOOOOOOOOOEB
BOOOOOOOOOOOOOOOOOOOOOOOOOOOOOOB
BBBBOOOOOOOOOOOOOOOOOOOOOOOOOOBB
BBBBOOPOOOOOOOOOPOOOOOOOOOPOOBBB
BBBBOOOOOOOOOOOOOOOOOOOOOOOOBBBB
BBBBBBBBBBBBBBBBBBBBBBBBBBBBBBBB
