BBBBBBBBBBBBBBBBBBBBBBBBBBBBBBBB
BOOOOOOOOOOOOOOOOOOOOOOOOOOOOOOB
BOOOOOOOOOOOOOOOOOOOOOOOOOOOOOOB
BOOOOOOOOOOOOOOOOOOOOOOOOOOOOOOB
BOOOOOOOOOOOOOOOOOOOOOOOOOOOOOOB
BOOOOOOOOOOOOOOOOOOOOOOOOOOOOOOB
BOOOOOOOOOOOOOOOOOOOOOOOOOPOOOOB
BBBBBBBBBBBBBBOOOOOOOOOOOOOOOOOB
BPOEOOOOOOOOOOOOOOOOOOOOOOOOOOOB
BOOOOOOOOOOOOOOOBBBBBBBBBBOOOOOB
BBBBOOOOOOOOOOOOBBOOOOOOOOOOOOOB
BOOOOOOOOOOOOOOOBBOOOOOOOOOOOOOB
BOOOOOOOOOOOOOOOBBOOOOOOOOOOOOOB
BOOOOOOOOOOOOOOOBBOOOOOOOOOOOOOB
BOOOOOOOOOOOOOOOBBOOOOOOOOOOOOOB
BOOOOOOOOOOOOOOOBBPOOOOOSOOOOOOB
BMMMMMMMMMMMMMMMBBOOOOOOOOOOOOOB
BBBBBBBBBBBBBBBBBBBBBBBBBBBBBBBB