BBBBBBBBBBBBBBBBBBBBBBBBBBBBBBBB
BOOOOOOOOOOOOOOOOOOOOOOOBOOOOOOB
BOOOOOOOOOOOOOOOOOOOOOOOBOOOOOPB
BOOOOOOOOOOOOOOOOOOOOOOOBOOOOOOB
BOOOOOOOOOOOOOOOOOOOOOOOBOOOOOOB
BOOOOOOOOOOOOOOOOOOOOOOOBOOOOOOB
BOOOOOOOOOOOOOOOOOOOOOOOBOOOOOOB
BOOOOOOOOOOOOOOOOOOOOOOOBOOOOOOB
BOOOOOOOOOOOOOOOOOOOOOOOBOOOOOOB
BOOOOOOOOOOOOOOOOOOOOOOOBOOOOOOB
BOOOOOOOOOOOOOOOOOOOOOOOBOOOOOOB
BOOOOOOOOOOOOOOOOOOOOOOOBOOOOOOB
BOOOOOOOOOOOOOOOOOOOOOOOBOOOOOOB
BOOOOOOOOOOOOOOOOOOOOOOOBOOOOOOB
BOOOOOOOOOOOOOOOOOOOOOOOBOOOOOOB
BOOOOOOOOOOOOOOOOOOOOOOOBOOOOOOB
BOOOSOOOOOOOOOOOOPOOOOOOBOOOOOOB
BBBBBBBBBBBBBBBBBBBBBBBBBBBBBBBB
