6
280 600 600 600 2 1 0 0 0 0
280 580 600 580 2 1 0 0 0 0
280 560 600 560 2 1 0 0 0 0
680 600 1000 600 2 1 0 0 0 0
680 580 1000 580 2 1 0 0 0 0
680 560 1000 560 2 1 0 0 0 0