BBBBBBBBBBBBBBBBBBBBBBBBBBBBBBBB
BOOOOOOOOOOOOOOOOOOOPOOOMOPOOOEB
BOOOOOOOOOOOOOOOOOOOOOOOMOOOOOOB
BOOOOOOOOOOOOOOOOBBBBBBBMOBBBBBB
BOOOOOOOOOOOBBBOOOOOOOOOOOOOOOOB
BOOOOOOOOOOOOOOOOOOOOOOOOOOOOOOB
BOOOOOOOOOOOOOOOOOOOOOOOOOOOOOOB
BOOOOOOOOOOOOOOOBBBOOOOOOOOOOOOB
BOOOOOOOOOOOOOOOOOOOOOOOOOOOOOOB
BOOOOOOOOOOOOOOOOOOOOOOOOOOOOOOB
BOOOOOOOOOOOBBBOOOOOOOOOOOOOOOOB
BOOOOOOOOOOOOOOOOOOOOOOOOOOOOOOB
BOOOOOOOOOOOOOOOOOOOOOOOOOOOOOOB
BOOOOOOOOOOOOOOOBBBOOOOOOOOOOOOB
BOOOOOOOOOOOOOOOOOOOOOOOOOOOOOOB
BSOOOOOOOOOOOOOOOOOOOOOOOOOOOOOB
BOOOOOOOOOOOBBBOOOOOOOOOOOOOOOOB
BBBBBBBBBBBBBBBBBBBBBBBBBBBBBBBB