BBBBBBBBBBBBBBBBBBBBBBBBBBBBBBBB
BOOOOOOOOOOOOOOOOOOOOOOOOOPOOOEB
BOOOOOOOOOOOOOOOOOOOOOOOOOOOOOOB
BOPOOOOOOOOOOBOOOOOOOOOOOBBBBBBB
BOOOOOOOOOOOOBOOOOOOOOOOOOOOOOOB
BOOOOOOOOOOOOOOBOOOOOOOOOOOOOOOB
BOOOOOOOOOOOOOOBOOOOOOOOOOOOOOOB
BOOOOOOOOOOOOOOBOOOOOOOOOOOOOOOB
BOOOOOOOOOOOOOOOOOBOOOOOOOOOOOOB
BOOOOOOOOOOOOOOOOOBOOOOOOOOOOOOB
BOOOOOOOOOOOOOOOOOBOOOOOOOOOOOOB
BOOOOOOOOOOOOOOBOOOOOOOOOOOOOOOB
BOOOOOOOOOOOOOOBOOOOOOOOOOOOOOOB
BOOOOOOOOOOOOOOBOOOOOOOOOOOOOOOB
BOOOOOOOOOOOOOOOOOBOOOOOOOOOOOOB
BOOOOOOOOOOOOOOOOOBOOOOOOOOOOOSB
BOOOOOOOCOOOOOOOOOBOOOOOOOOOOOOB
BBBBBBBBBBBBBBBBBBBBBBBBBBBBBBBB