BBBBBBBBBBBBBBBBBBBBBBBBBBBBBBBB
BEOOOOOOOOOOOOOOOOOOOOOOOOOOOOOB
BOOOOOOOOOOOOOOOOOOOOOOOOOOOOPOB
BBBOOOOOOOOOOOOOOOOOOOOOOOOOOOOB
BBBOOOOOOOOOOOOOOOOOOOOOOOOOOOOB
BBBOOOOOOOOOOOOOOOOOOOOOOOOOOOOB
BBBOOOOOOOOOOOOOOOOOOOOOOOOOOOOB
BBBOOOCOOOOOCOOOOOCOOOOOCOOOOOOB
BBBBBBBBBBBBBBBBBBBBBBBBBBBBBOOB
BOOOOOOOOOOOOOOOOOOOOOOOOOOOOOOB
BPOOOOOOOOOOOOOOOOOOOOOOOOOOOOOB
BOOOOOOOOOOOOOOOOOOOOOOOOOOOOOOB
BBBOOOOOOOOOOOOOOOOOOOOOOOOOOOOB
BBBOOOOOOOOOOOOOOOOOOOOOOOOOOOOB
BBBOOOOOOOOOOOOOOOOOOOOOOOOOOOBB
BBBSOOOOOOOOOOOOOOOOOOOOOOOOOOBB
BBBOOOOCOOOOOCOOOOOCOOOOOCOOOOBB
BBBBBBBBBBBBBBBBBBBBBBBBBBBBBBBB