BBBBBBBBBBBBBBBBBBBBBBBBBBBBBBBB
BOOOOOOOOOOOOOOOOOOOOOOOOOPOOOEB
BOOOOOOOOOOOOOOOOOOOOOOOOOOOOOOB
BOOOOOOOOOOOOOOOOOOOOOOOOBBBBBBB
BOOOOOOOOOOOOOOOOOOOOOOOOOOOOOOB
BOOOOOOOOOOOOOOOOOOOOOOOOOOOOOOB
BOOOOOOOOOOOOOOOOOOOOOOOOOOOOOOB
BPOOOOOOOOOOCOOOOOOOOOOOOOOOOOOB
BOOOOOOOOOOOBOOOOOOOOOOOOOOOOOOB
BOOOOOOOOOCOBOOOOOOOOOOOOOOOOOOB
BOOOOOOOOOBOBOOOOOOOOOOOOOOOOOOB
BOOOOOOOCOBOBOOOOOOOOOOOOOOOOOOB
BOOOOOOOBOBOBOOOOOOOOOOOOOOOOOOB
BOOOOOCOBOBOBOOOOOOOOOOOOOOOOOOB
BOOOOOBOBOBOBOOOOOOOOOOOOOOOOOOB
BSOOOOBOBOBOBOOOOOOOOOOOOOOOOOOB
BOOOBOBOBOBOBOOOOOOOOOOOOOOOOOOB
BBBBBBBBBBBBBBBBBBBBBBBBBBBBBBBB