BBBBBBBBBBBBBBBBBBBBBBBBBBBBBBBB
BOOOOOOOOOOOOOOOOOOOOOOOOOOOOOOB
BOOOOOOOOOOOOOOOOOOOOOOOOOOOOOEB
BOOOOOOOOOOOOOOOOOOOOOOOOOOOOOOB
BOOOOOOOOOOBBBBBBBBBMBMBMBMBMBBB
BBBBBBOOOOBOOOOBOOOOOOOOOOOOOOPB
BBBBBBOOOOOOOOOOOOOOOOOOOOOOOOOB
BOOOOOOOOOOOOOOOOOOOOOOOOOOOOOOB
BOOOOOOOOPOOOOOOOOOOOOOOOOOOOOOB
BOOOOOOOOOOOOOOBOOOOOOOOOOOOOOOB
BOOOOOOOOOOOOOOOOOOOOOOOOOOOOOOB
BOOOOOOOOOOOOOOOOOOOOOOOOOOOOOOB
BOOOOOOOOOOOOOOOOOOBOOOOOOOOOOOB
BOOOOOOOOOOOOOOOOOOBOOOOOOOOOOOB
BOOOOOOOOOOOOOOOOOPBOOOOOBOOOOOB
BSOOOOOOOOOOOOOOOOOBOOOOOBOOOOOB
BOOOOOOOOOOOOOOOOOCBOOOOOBOOOOOB
BBBBBBBBBBBBBBBBBBBBBBBBBBBBBBBB