16
40 40 40 40 0 1 1 250 2 0 0
40 80 40 80 0 1 1 250 2 0 0
40 120 40 120 0 1 1 250 2 0 0
40 160 40 160 0 1 1 250 2 0 0
40 200 40 200 0 1 1 250 2 0 0
40 240 40 240 0 1 1 200 2 0 0
40 280 40 280 0 1 1 200 2 0 0
40 320 40 320 0 1 1 200 2 0 0
40 360 40 360 0 1 1 200 2 0 0
40 400 40 400 0 1 1 200 2 0 0
40 440 40 440 0 1 1 200 2 0 0
40 480 40 480 0 1 1 200 2 0 0
40 520 40 520 0 1 1 200 2 0 0
40 560 40 560 0 1 1 200 2 0 0
40 600 40 600 0 1 1 200 2 0 0
40 640 40 640 0 1 1 200 2 0 0