BBBBBBBBBBBBBBBBBBBBBBBBBBBBBBBB
BOOOOOOOBOOOOOOOBOOOOOOOBOOOOOOB
BOOOOOOOBOOOOOOOBOOOOOOOBOOOOOOB
BOOOOOOOBOOOOOOOBOOOOOOOBOOOOOOB
BOOOPOOOBOOOPOOOBOOOPOOOBOOOOOOB
BOOOOOOOBOOOOOOOBOOOOOOOBOOOOOOB
BOOOBOOOBOOOBOOOBOOOBOOOBOOOOOOB
BOOOBOOOBOOOBOOOBOOOBOOOBOOOOOOB
BOOOBOOOBOOOBOOOBOOOBOOOBOOOOOOB
BOOOBOOOBOOOBOOOBOOOBOOOBOOOOOOB
BOOOBOOOBOOOBOOOBOOOBOOOBOOOOOOB
BOOOBOOOBOOOBOOOBOOOBOOOBOOOOOOB
BOOOBOOOOOOOBOOOOOOOBOOOOOOOOOOB
BOOOBOOOPOOOBOOOPOOOBOOOPOOOOOOB
BOOOBOOOOOOOBOOOOOOOBOOOOOOOOOOB
BSOPBOOOOOOOBOOOOOOOBOOOOOOOOOEB
BOOOBOOOOOOOBOOOOOOOBOOOOOOOOOOB
BBBBBBBBBBBBBBBBBBBBBBBBBBBBBBBB