10
200 360 240 360 1 1 0 0 0 0 0
240 360 280 360 1 1 0 0 0 0 0
360 360 400 360 1 1 0 0 0 0 0
400 360 440 360 1 1 0 0 0 0 0
520 360 560 360 1 1 0 0 0 0 0
560 360 600 360 1 1 0 0 0 0 0
680 360 720 360 1 1 0 0 0 0 0
720 360 760 360 1 1 0 0 0 0 0
840 360 880 360 1 1 0 0 0 0 0
880 360 920 360 1 1 0 0 0 0 0